của	of
một	a
trong	in
nó	it
tôi	I
cái đó	that
cho	for
bạn	you
anh ta	he
với	with
trên	on
làm	do
Nói	say
điều này	this
họ	they
tại	at
nhưng	but
chúng tôi	we
của anh ấy	his
từ	from
cái đó	that
không phải	not
bởi	by
chị ấy	she
hoặc là	or
như	as
gì	what
đi	go
họ	their
có thể	can
người nào	who
được	get
nếu	if
sẽ	would
cô ấy	her
tất cả các	all
tôi	my
chế tạo	make
trong khoảng	about
biết	know
sẽ	will
như	as
lên	up
một	one
thời gian	time
ở đó	there
năm	year
vì thế	so
suy nghĩ	think
khi nào	when
mà	which
họ	them
một số	some
tôi	me
những người	people
lấy	take
ngoài	out
vào	into
chỉ	just
xem	see
anh ta	him
của bạn	your
đến	come
có thể	could
hiện nay	now
hơn	than
như	like
khác	other
làm sao	how
sau đó	then
của nó	its
của chúng ta	our
hai	two
hơn	more
những	these
muốn	want
đường	way
nhìn	look
Đầu tiên	first
cũng thế	also
Mới	new
bởi vì	because
ngày	day
hơn	more
sử dụng	use
Không	no
Đàn ông	man
tìm thấy	find
đây	here
Điều	thing
đưa cho	give
nhiều	many
tốt	well
chỉ có	only
những	those
cái đó	those
nói	tell
một	one
rất	very
cô ấy	her
cũng	even
trở lại	back
bất kì	any
tốt	good
đàn bà	woman
xuyên qua	through
chúng tôi	us
đời sống	life
đứa trẻ	child
ở đó	there
công việc	work
xuống	down
Tháng Năm	may
sau	after
Nên	should
gọi	call
thế giới	world
kết thúc	over
trường học	school
vẫn	still
thử	try
trong	in
như	as
Cuối cùng	last
hỏi	ask
nhu cầu	need
quá	too
cảm thấy	feel
số ba	three
khi nào	when
tiểu bang	state
không bao giờ	never
trở nên	become
giữa	between
cao	high
có thật không	really
cái gì đó	something
phần lớn	most
khác	another
nhiều	much
gia đình	family
sở hữu	own
ngoài	out
rời khỏi	leave
đặt	put
cũ	old
trong khi	while
nghĩa là	mean
trên	on
giữ	keep
sinh viên	student
tại sao	why
để cho	let
tuyệt quá	great
tương tự	same
lớn	big
nhóm	group
bắt đầu	begin
hình như	seem
Quốc gia	country
Cứu giúp	help
nói chuyện	talk
Ở đâu	where
xoay	turn
vấn đề	problem
mỗi	every
khởi đầu	start
tay	hand
có thể	might
Người Mỹ	American
chỉ	show
phần	part
trong khoảng	about
chống lại	against
địa điểm	place
kết thúc	over
như là	such
lần nữa	again
vài	few
trường hợp	case
phần lớn	most
tuần	week
Công ty	company
Ở đâu	where
hệ thống	system
mỗi	each
đúng	right
chương trình	program
Nghe	hear
vì thế	so
câu hỏi	question
suốt trong	during
công việc	work
chơi	play
chính quyền	government
chạy	run
nhỏ bé	small
con số	number
tắt	off
luôn luôn	always
di chuyển	move
như	like
đêm	night
trực tiếp	live
Ông	Mr
điểm	point
tin	believe
giữ	hold
hôm nay	today
mang đến	bring
xảy ra	happen
kế tiếp	next
không có	without
trước	before
lớn	large
tất cả các	all
triệu	million
phải	must
nhà	home
Dưới	under
Nước	water
phòng	room
viết	write
mẹ	mother
khu vực	area
Quốc gia	national
tiền bạc	money
câu chuyện	story
trẻ	young
thực tế	fact
tháng	month
khác nhau	different
nhiều	lot
đúng	right
học	study
sách	book
mắt	eye
việc làm	job
từ	word
Tuy nhiên	though
kinh doanh	business
vấn đề	issue
bên	side
loại	kind
bốn	four
cái đầu	head
xa	far
đen	black
Dài	long
cả hai	both
ít	little
nhà ở	house
Vâng	yes
sau	after
kể từ	since
Dài	long
cung cấp	provide
dịch vụ	service
xung quanh	around
người bạn	friend
quan trọng	important
cha	father
ngồi	sit
xa	away
cho đến	until
quyền lực	power
giờ	hour
trò chơi	game
thường xuyên	often
chưa	yet
hàng	line
chính trị	political
kết thúc	end
trong số	among
không bao giờ	ever
đứng	stand
xấu	bad
thua	lose
Tuy nhiên	however
hội viên	member
trả	pay
pháp luật	law
gặp	meet
xe hơi	car
thành phố	city
hầu hết	almost
bao gồm	include
tiếp tục	continue
bộ	set
một lát sau	later
cộng đồng	community
nhiều	much
Tên	name
số năm	five
Một lần	once
trắng	white
ít nhất	least
chủ tịch	president
học hỏi	learn
thực	real
thay đổi	change
đội	team
phút	minute
tốt	best
một số	several
ý kiến	idea
đứa trẻ	kid
thân hình	body
thông tin	information
không có gì	nothing
trước	ago
đúng	right
xã hội	social
hiểu không	understand
liệu	whether
trở lại	back
đồng hồ đeo tay	watch
cùng với nhau	together
theo	follow
xung quanh	around
cha mẹ	parent
chỉ có	only
dừng lại	stop
đối mặt	face
bất cứ điều gì	anything
tạo nên	create
công cộng	public
đã	already
nói	speak
Khác	others
đọc	read
cấp độ	level
cho phép	allow
thêm vào	add
văn phòng	office
tiêu	spend
cửa	door
Sức khỏe	health
người	person
nghệ thuật	art
chắc chắn rồi	sure
như là	such
chiến tranh	war
lịch sử	history
buổi tiệc	party
bên trong	within
lớn lên	grow
kết quả	result
mở	open
thay đổi	change
buổi sáng	morning
đi bộ	walk
lý do	reason
thấp	low
thắng lợi	win
nghiên cứu	research
con gái	girl
chàng	guy
sớm	early
món ăn	food
trước	before
chốc lát	moment
bản thân anh ấy	himself
không khí	air
giáo viên	teacher
lực lượng	force
phục vụ	offer
đủ	enough
cả hai	both
giáo dục	education
băng qua	across
mặc dù	although
nhớ lại	remember
chân	foot
thứ hai	second
con trai	boy
có lẽ	maybe
đối với	toward
có thể	able
tuổi tác	age
tắt	off
chính sách	policy
mọi điều	everything
yêu	love
quá trình	process
Âm nhạc	music
kể cả	including
xem xét	consider
xuất hiện	appear
thực ra	actually
mua	buy
có lẽ	probably
Nhân loại	human
chờ đợi	wait
phục vụ	serve
thị trường	market
chết	die
gửi	send
chờ đợi	expect
nhà	home
giác quan	sense
xây dựng	build
ở lại	stay
ngã	fall
Oh	oh
quốc gia	nation
kế hoạch	plan
cắt tỉa	cut
trường đại học	college
quan tâm	interest
tử vong	death
khóa học	course
người nào	someone
kinh nghiệm	experience
phía sau	behind
chạm tới	reach
địa phương	local
giết chết	kill
sáu	six
vẫn còn	remain
hiệu ứng	effect
sử dụng	use
yeah	yeah
đề nghị	suggest
lớp học	class
điều khiển	control
nâng cao	raise
quan tâm	care
có lẽ	perhaps
ít	little
muộn	late
cứng	hard
cánh đồng	field
khác	else
vượt qua	pass
trước đây	former
bán	sell
chính	major
đôi khi	sometimes
yêu cầu	require
dọc theo	along
phát triển	development
bản thân họ	themselves
bài báo cáo	report
vai trò	role
tốt hơn	better
thuộc kinh tế	economic
cố gắng	effort
lên	up
quyết định	decide
tỷ lệ	rate
mạnh	strong
khả thi	possible
tim	heart
thuốc uống	drug
chỉ	show
lãnh đạo	leader
ánh sáng	light
tiếng nói	voice
người vợ	wife
toàn thể	whole
cảnh sát	police
lí trí	mind
cuối cùng	finally
kéo	pull
trở về	return
miễn phí	free
quân đội	military
giá bán	price
bài báo cáo	report
ít hơn	less
theo	according
phán quyết	decision
giải thích	explain
Con trai	son
mong	hope
cũng	even
phát triển	develop
xây dựng	develop
lượt xem	view
mối quan hệ	relationship
mang	carry
thị trấn	town
đường	road
lái xe	drive
cánh tay	arm
THẬT	TRUE
liên bang	federal
phá vỡ	break
tốt hơn	better
Sự khác biệt	difference
cảm tạ	thank
nhận được	receive
giá trị	value
quốc tế	international
Tòa nhà	building
hoạt động	action
đầy	full
mô hình	model
tham gia	join
Mùa	season
xã hội	society
bởi vì	because
Thuế	tax
giám đốc	director
sớm	early
Chức vụ	position
người chơi	player
đồng ý	agree
đặc biệt	especially
ghi lại	record
chọn	pick
mặc	wear
giấy	paper
đặc biệt	special
không gian	space
đất	ground
hình thức	form
ủng hộ	support
biến cố	event
chính thức	official
có	whose
vấn đề	matter
tất cả mọi người	everyone
Trung tâm	center
vợ chồng	couple
địa điểm	site
kết thúc	end
dự án	project
đánh	hit
căn cứ	base
Hoạt động	activity
ngôi sao	star
bàn	table
nhu cầu	need
tòa án	court
sản xuất	produce
ăn	eat
Người Mỹ	American
dạy	teach
dầu	oil
một nửa	half
tình hình	situation
dễ dàng	easy
Giá cả	cost
ngành công nghiệp	industry
nhân vật	figure
đối mặt	face
đường phố	street
hình ảnh	image
chính no	itself
điện thoại	phone
hoặc	either
dữ liệu	data
che	cover
khá	quite
hình ảnh	picture
trong sáng	clear
thực hành	practice
cái	piece
đất đai	land
gần đây	recent
miêu tả	describe
sản phẩm	product
Bác sĩ	doctor
Tường	wall
bệnh nhân	patient
công nhân	worker
Tin tức	news
thử nghiệm	test
bộ phim	movie
chắc chắn	certain
Bắc	north
yêu	love
cá nhân	personal
mở	open
ủng hộ	support
đơn giản	simply
thứ ba	third
Công nghệ	technology
bắt lấy	catch
bậc thang	step
đứa bé	baby
máy vi tính	computer
kiểu	type
chú ý	attention
vẽ tranh	draw
phim ảnh	film
Đảng Cộng hòa	Republican
cây	tree
nguồn	source
đỏ	red
Gần	nearly
cơ quan	organization
chọn	choose
nguyên nhân	cause
tóc	hair
nhìn	look
điểm	point
thế kỷ	century
chứng cớ	evidence
cửa sổ	window
khó khăn	difficult
nghe	listen
Sớm	soon
nền văn hóa	culture
tỷ	billion
cơ hội	chance
em trai	brother
năng lượng	energy
giai đoạn	period
khóa học	course
mùa hè	summer
ít hơn	less
nhận ra	realize
hàng trăm	hundred
có sẵn	available
thực vật	plant
có khả năng	likely
cơ hội	opportunity
kỳ hạn	term
ngắn	short
lá thư	letter
điều kiện	condition
lựa chọn	choice
địa điểm	place
Độc thân	single
qui định	rule
Con gái	daughter
quản trị	administration
miền Nam	south
người chồng	husband
Hội nghị	Congress
sàn nhà	floor
chiến dịch	campaign
vật chất	material
dân số	population
tốt	well
gọi	call
nên kinh tê	economy
Y khoa	medical
bệnh viện	hospital
nhà thờ	church
gần	close
nghìn	thousand
rủi ro	risk
hiện hành	current
ngọn lửa	fire
Tương lai	future
sai rồi	wrong
liên quan	involve
phòng thủ	defense
bất kỳ ai	anyone
tăng	increase
Bảo vệ	security
ngân hàng	bank
riêng tôi	myself
chắc chắn	certainly
hướng Tây	west
môn thể thao	sport
bảng	board
tìm kiếm	seek
mỗi	per
môn học	subject
nhân viên văn phòng	officer
riêng tư	private
nghỉ ngơi	rest
hành vi	behavior
thỏa thuận	deal
hiệu suất	performance
chiến đấu	fight
ném	throw
hàng đầu	top
Mau	quickly
quá khứ	past
mục tiêu	goal
thứ hai	second
Giường	bed
gọi món	order
tác giả	author
lấp đầy	fill
đại diện	represent
tiêu điểm	focus
ngoại quốc	foreign
rơi vãi	drop
kế hoạch	plan
máu	blood
trên	upon
đại lý	agency
đẩy	push
thiên nhiên	nature
màu	color
Không	no
gần đây	recently
cửa hàng	store
giảm	reduce
âm thanh	sound
chú thích	note
khỏe	fine
trước	before
ở gần	near
phong trào	movement
trang	page
đi vào	enter
chia sẻ	share
hơn	than
chung	common
nghèo nàn	poor
khác	other
tự nhiên	natural
cuộc đua	race
mối quan ngại	concern
loạt	series
có ý nghĩa	significant
giống	similar
nóng bức	hot
ngôn ngữ	language
mỗi	each
thông thường	usually
phản ứng	response
đã chết	dead
tăng lên	rise
thú vật	animal
hệ số	factor
thập kỷ	decade
bài báo	article
bắn	shoot
Đông	east
tiết kiệm	save
bảy	seven
họa sĩ	artist
xa	away
bối cảnh	scene
cổ phần	stock
nghề nghiệp	career
mặc dù	despite
Trung tâm	central
tám	eight
do đó	thus
điều trị	treatment
vượt ra ngoài	beyond
vui mừng	happy
chính xác	exactly
bảo vệ	protect
tiếp cận	approach
nói dối	lie
kích thước	size
chó	dog
quỹ	fund
nghiêm trọng	serious
xảy ra	occur
phương tiện truyền thông	media
sẳn sàng	ready
ký tên	sign
nghĩ	thought
danh sách	list
cá nhân	individual
đơn giản	simple
phẩm chất	quality
sức ép	pressure
Chấp nhận	accept
câu trả lời	answer
cứng	hard
tài nguyên	resource
nhận định	identify
trái	left
gặp gỡ	meeting
mục đích	determine
chuẩn bị	prepare
dịch bệnh	disease
bất cứ điều gì	whatever
sự thành công	success
tranh luận	argue
tách	cup
đặc biệt	particularly
số lượng	amount
có khả năng	ability
cán bộ	staff
nhìn nhận	recognize
biểu thị	indicate
tính cách	character
sự phát triển	growth
mất mát	loss
trình độ	degree
ngạc nhiên	wonder
tấn công	attack
cô ấy	herself
khu vực	region
tivi	television
cái hộp	box
TV	TV
đào tạo	training
đẹp	pretty
buôn bán	trade
thỏa thuận	deal
cuộc bầu cử	election
mọi người	everybody
vật lý	physical
đặt nằm	lay
chung	general
cảm giác	feeling
Tiêu chuẩn	standard
hóa đơn	bill
thông điệp	message
Thất bại	fail
ở ngoài	outside
đến nơi	arrive
phân tích	analysis
lợi ích	benefit
Tên	name
tình dục	sex
phía trước	forward
luật sư	lawyer
hiện tại	present
phần	section
môi trường	environmental
ly	glass
câu trả lời	answer
kỹ năng	skill
em gái	sister
PM	PM
Giáo sư	professor
hoạt động	operation
tài chính	financial
tội ác	crime
sân khấu	stage
được	ok
so sánh	compare
thẩm quyền	authority
bỏ lỡ	miss
thiết kế	design
sắp xếp	sort
một	one
hành động	act
mười	ten
hiểu biết	knowledge
súng	gun
ga tàu	station
màu xanh da trời	blue
tiểu bang	state
chiến lược	strategy
ít	little
thông suốt	clearly
bàn luận	discuss
thật	indeed
lực lượng	force
sự thật	truth
bài hát	song
thí dụ	example
dân chủ	democratic
kiểm tra	check
môi trường	environment
Chân	leg
tối	dark
công cộng	public
nhiều	various
hơn	rather
cười	laugh
phỏng đoán	guess
điều hành	executive
bộ	set
học	study
chứng minh	prove
treo	hang
toàn bộ	entire
đá	rock
thiết kế	design
đủ	enough
quên	forget
kể từ	since
yêu cầu	claim
chú thích	note
tẩy	remove
giám đốc	manager
Cứu giúp	help
gần	close
âm thanh	sound
thưởng thức	enjoy
mạng	network
hợp pháp	legal
Tôn giáo	religious
lạnh	cold
hình thức	form
sau cùng	final
chủ yếu	main
khoa học	science
màu xanh lá	green
ký ức	memory
Thẻ	card
ở trên	above
ghế	seat
tế bào	cell
thành lập	establish
tốt đẹp	nice
thử nghiệm	trial
chuyên gia	expert
cái đó	that
mùa xuân	spring
chắc chắn	firm
Dân chủ	Democrat
radio	radio
chuyến thăm	visit
sự quản lý	management
quan tâm	care
tránh	avoid
tưởng tượng	imagine
tối nay	tonight
khổng lồ	huge
trái bóng	ball
Không	no
gần	close
hoàn thành	finish
bản thân bạn	yourself
nói chuyện	talk
lý thuyết	theory
va chạm	impact
trả lời	respond
tuyên bố	statement
duy trì	maintain
sạc điện	charge
phổ biến	popular
truyên thông	traditional
trên	onto
tiết lộ	reveal
phương hướng	direction
vũ khí	weapon
Nhân viên	employee
văn hoá	cultural
chứa	contain
hòa bình	peace
cái đầu	head
điều khiển	control
căn cứ	base
đau đớn	pain
ứng dụng	apply
chơi	play
đo	measure
rộng	wide
lắc	shake
bay	fly
phỏng vấn	interview
quản lý	manage
cái ghế	chair
cá	fish
cụ thể	particular
Máy ảnh	camera
kết cấu	structure
chính trị	politics
biểu diễn	perform
bit	bit
cân nặng	weight
đột ngột	suddenly
khám phá	discover
ứng viên	candidate
hàng đầu	top
sản xuất	production
đãi	treat
chuyến đi	trip
tối	evening
có ảnh hưởng đến	affect
phía trong	inside
hội nghị	conference
đơn vị	unit
tốt	best
Phong cách	style
người lớn	adult
lo	worry
phạm vi	range
đề cập đến	mention
hơn	rather
xa	far
sâu	deep
quá khứ	past
cạnh	edge
cá nhân	individual
riêng	specific
nhà văn	writer
rắc rối	trouble
cần thiết	necessary
khắp	throughout
thử thách	challenge
nỗi sợ	fear
vai	shoulder
tổ chức	institution
ở giữa	middle
biển	sea
mơ tưởng	dream
quán ba	bar
đẹp	beautiful
bất động sản	property
thay thế	instead
cải tiến	improve
đồ đạc	stuff
chi tiết	detail
phương pháp	method
ký tên	sign
có ai	somebody
tạp chí	magazine
khách sạn	hotel
lính	soldier
phản chiếu	reflect
nặng	heavy
tình dục	sexual
nguyên nhân	cause
túi	bag
nhiệt	heat
ngã	fall
kết hôn	marriage
khó khăn	tough
hát	sing
bề mặt	surface
mục đích	purpose
hiện hữu	exist
mẫu	pattern
ai	whom
da	skin
đặc vụ	agent
chủ nhân	owner
máy móc	machine
khí đốt	gas
xuống	down
phía trước	ahead
thế hệ	generation
thương mại	commercial
địa chỉ nhà	address
ung thư	cancer
thử nghiệm	test
mục	item
thực tế	reality
huấn luyện viên	coach
bậc thang	step
Bà	Mrs
sân	yard
tiết tấu	beat
bạo lực	violence
toàn bộ	total
có xu hướng	tend
đầu tư	investment
thảo luận	discussion
ngón tay	finger
vườn	garden
để ý	notice
bộ sưu tập	collection
hiện đại	modern
bài tập	task
cộng sự	partner
tích cực	positive
dân sự	civil
phòng bếp	kitchen
khách hàng	consumer
bắn	shot
ngân sách	budget
muốn	wish
bức vẽ	painting
nhà khoa học	scientist
an toàn	safe
thỏa thuận	agreement
thủ đô	capital
miệng	mouth
cũng không	nor
nạn nhân	victim
báo chí	newspaper
thay thế	instead
mối đe dọa	threat
trách nhiệm	responsibility
nụ cười	smile
luật sư	attorney
ghi bàn	score
tài khoản	account
hấp dẫn	interesting
phá vỡ	break
thính giả	audience
giàu có	rich
bữa tối	dinner
nhân vật	figure
bỏ phiếu	vote
miền Tây	western
liên hệ	relate
du lịch	travel
tranh luận	debate
ngăn chặn	prevent
công dân	citizen
đa số	majority
không ai	none
trước mặt	front
sinh ra	born
thừa nhận	admit
cao cấp	senior
giả định	assume
gió	wind
Chìa khóa	key
chuyên nghiệp	professional
sứ mệnh	mission
Nhanh	fast
một mình	alone
khách hàng	customer
đau khổ	suffer
phát biểu	speech
thành công	successful
Tùy chọn	option
người tham gia	participant
phía Nam	southern
tươi	fresh
cuối cùng	eventually
Không	no
rừng	forest
video	video
toàn cầu	global
Thượng nghị viện	Senate
cải cách	reform
truy cập	access
nhà hàng	restaurant
thẩm phán	judge
công bố	publish
Giá cả	cost
quan hệ	relation
như	like
giải phóng	release
sở hữu	own
chim	bird
quan điểm	opinion
tín dụng	credit
chỉ trích	critical
góc	corner
liên quan	concerned
hồi tưởng	recall
phiên bản	version
nhìn chằm chằm	stare
an toàn	safety
có hiệu lực	effective
khu vực lân cận	neighborhood
nguyên	original
hành động	act
quân	troop
thu nhập	income
trực tiếp	directly
đau	hurt
loài	species
ngay	immediately
theo dõi	track
căn bản	basic
đình công	strike
mong	hope
bầu trời	sky
sự tự do	freedom
chắc chắn rồi	absolutely
máy bay	plane
không ai	nobody
Hoàn thành	achieve
vật	object
Thái độ	attitude
lao động	labor
tham khảo	refer
khái niệm	concept
khách hàng	client
quyền lực	powerful
hoàn hảo	perfect
chín	nine
vì thế	therefore
hạnh kiểm	conduct
tuyên bố	announce
cuộc hội thoại	conversation
xem xét	examine
chạm	touch
xin vui lòng	please
tham gia	attend
hoàn toàn	completely
bỏ phiếu	vote
đa dạng	variety
ngủ	sleep
xoay	turn
có tính liên quan	involved
cuộc điều tra	investigation
Nguyên tử	nuclear
nghiên cứu viên	researcher
nhấn	press
cuộc xung đột	conflict
tinh thần	spirit
kinh nghiệm	experience
thay thế	replace
người Anh	British
khuyến khích	encourage
tranh luận	argument
bởi	by
Một lần	once
trại	camp
óc	brain
đặc tính	feature
buổi chiều	afternoon
LÀ	AM
ngày cuối tuần	weekend
tá	dozen
khả năng	possibility
dọc theo	along
bảo hiểm	insurance
bộ phận	department
chiến đấu	battle
bắt đầu	beginning
ngày	date
nói chung là	generally
Châu Phi	African
rất	very
lấy làm tiếc	sorry
khủng hoảng	crisis
hoàn thành	complete
quạt	fan
gậy	stick
định nghĩa	define
dễ dàng	easily
xuyên qua	through
lỗ	hole
thành phần	element
tầm nhìn	vision
trạng thái	status
bình thường	normal
Trung Quốc	Chinese
tàu	ship
dung dịch	solution
Cục đá	stone
chậm rãi	slowly
tỉ lệ	scale
bit	bit
trường đại học	university
giới thiệu	introduce
người lái xe	driver
cố gắng	attempt
công viên	park
nơi	spot
thiếu sót	lack
Nước đá	ice
thuyền	boat
uống	drink
mặt trời	sun
trước mặt	front
khoảng cách	distance
gỗ	wood
xử lý	handle
xe tải	truck
trở về	return
núi	mountain
khảo sát	survey
giả định	supposed
truyền thống	tradition
mùa đông	winter
làng	village
Liên Xô	Soviet
từ chối	refuse
bán hàng	sales
cuộn	roll
giao tiếp	communication
chạy	run
màn	screen
thu được	gain
cư dân	resident
ẩn giấu	hide
vàng	gold
câu lạc bộ	club
Tương lai	future
nông trại	farm
tiềm năng	potential
tăng	increase
ở giữa	middle
Châu Âu	European
sự hiện diện	presence
độc lập	independent
huyện	district
hình dạng	shape
người đọc	reader
Cô	Ms
hợp đồng	contract
đám đông	crowd
Christian	Christian
bày tỏ	express
căn hộ	apartment
chung cư	apartment
sẵn lòng	willing
sức mạnh	strength
Trước	previous
ban nhạc	band
chắc chắn	obviously
con ngựa	horse
quan tâm	interested
Mục tiêu	target
nhà tù	prison
dap xe	ride
bảo vệ	guard
điều kiện	terms
nhu cầu	demand
phóng viên	reporter
giao hàng	deliver
bản văn	text
chia sẻ	share
dụng cụ	tool
hoang dã	wild
phương tiện	vehicle
quan sát	observe
chuyến bay	flight
phía trong	inside
cơ sở	facility
hiểu biết	understanding
Trung bình cộng	average
hiện ra	emerge
lợi thế	advantage
nhanh chóng	quick
ánh sáng	light
khả năng lãnh đạo	leadership
kiếm	earn
pao	pound
nền tảng	basis
sáng	bright
vận hành	operate
khách	guest
mẫu vật	sample
Góp phần	contribute
nhỏ bé	tiny
khối	block
sự bảo vệ	protection
ổn định	settle
nuôi	feed
sưu tầm	collect
bổ sung	additional
trong khi	while
cao	highly
danh tính	identity
chức vụ	title
chủ yếu	mostly
bài học	lesson
đức tin	faith
con sông	river
Quảng bá	promote
sống	living
hiện tại	present
đếm	count
trừ khi	unless
kết hôn	marry
Ngày mai	tomorrow
kỹ thuật	technique
con đường	path
tai	ear
cửa tiệm	shop
dân gian	folk
gọi món	order
nguyên tắc	principle
tồn tại	survive
thang máy	lift
biên giới	border
cuộc thi	competition
nhảy	jump
tụ họp	gather
giới hạn	limit
Phù hợp	fit
yêu cầu	claim
khóc	cry
Trang thiết bị	equipment
giá trị	worth
liên kết	associate
nhà phê bình	critic
ấm áp	warm
khía cạnh	aspect
kết quả	result
năn nỉ	insist
thất bại	failure
hàng năm	annual
người Pháp	French
Giáng Sinh	Christmas
bình luận	comment
chịu trách nhiệm	responsible
chuyện	affair
tiếp cận	approach
cho đến	until
thủ tục	procedure
đều đặn	regular
Lan tràn	spread
Chủ tịch	chairman
bóng chày	baseball
mềm mại	soft
bỏ qua	ignore
trứng	egg
đo	measure
niềm tin	belief
chứng minh	demonstrate
bất kỳ ai	anybody
giết người	murder
quà tặng	gift
tôn giáo	religion
ôn tập	review
người biên tập	editor
quá khứ	past
thuê	engage
cà phê	coffee
tài liệu	document
tốc độ	speed
vượt qua	cross
ảnh hưởng	influence
dù sao	anyway
hăm dọa	threaten
cam kết	commit
giống cái	female
thiếu niên	youth
làn sóng	wave
di chuyển	move
sợ	afraid
phần tư	quarter
lý lịch	background
tự nhiên	native
rộng lớn	broad
Tuyệt vời	wonderful
phủ nhận	deny
dường như	apparently
khinh bỉ	slightly
phản ứng	reaction
hai lần	twice
bộ đồ	suit
quan điểm	perspective
phát triển	growing
thổi	blow
xây dựng	construction
loại	kind
Sự thông minh	intelligence
hủy hoại	destroy
nấu ăn	cook
kết nối	connection
sạc điện	charge
đốt cháy	burn
giày	shoe
lượt xem	view
cấp	grade
bối cảnh	context
ủy ban	committee
Chào	hey
sai lầm	mistake
tiêu điểm	focus
nụ cười	smile
vị trí	location
quần áo	clothes
người Ấn Độ	Indian
Yên tĩnh	quiet
trang phục	dress
lời hứa	promise
ý thức	aware
hàng xóm	neighbor
hoàn thành	complete
lái xe	drive
chức năng	function
khúc xương	bone
đang hoạt động	active
mở rộng	extend
giám đốc	chief
Trung bình cộng	average
phối hợp	combine
rượu nho	wine
phía dưới	below
mát mẻ	cool
cử tri	voter
nghĩa là	means
nhu cầu	demand
học tập	learning
xe buýt	bus
Địa ngục	hell
nguy hiểm	dangerous
nhắc lại	remind
đạo đức	moral
United	United
thể loại	category
tương đối	relatively
chiến thắng	victory
Chìa khóa	key
học tập	academic
chuyến thăm	visit
Internet	Internet
khỏe mạnh	healthy
ngọn lửa	fire
tiêu cực	negative
tiếp theo	following
lịch sử	historical
dược phẩm	medicine
chuyến du lịch	tour
tùy theo	depend
hình chụp	photo
Phát hiện	finding
vồ lấy	grab
thẳng thắn	direct
phòng học	classroom
tiếp xúc	contact
Sự công bằng	justice
tham dự	participate
hằng ngày	daily
hội chợ	fair
đôi	pair
nổi danh	famous
tập thể dục	exercise
đầu gối	knee
hoa	flower
băng	tape
thuê mướn	hire
quen	familiar
thích hợp	appropriate
cung cấp	supply
đầy đủ	fully
cắt tỉa	cut
sẽ	will
diễn viên	actor
Sinh	birth
Tìm kiếm	search
cà vạt	tie
dân chủ	democracy
phương Đông	eastern
sơ cấp	primary
hôm qua	yesterday
vòng tròn	circle
thiết bị	device
tiến độ	progress
kế tiếp	next
trước mặt	front
đáy	bottom
Đảo	island
trao đổi	exchange
giao dịch	exchange
dọn dẹp	clean
studio	studio
xe lửa	train
quý bà	lady
đồng nghiệp	colleague
ứng dụng	application
cái cổ	neck
nạc	lean
hư hại	damage
nhựa	plastic
cao	tall
đĩa	plate
ghét bỏ	hate
nếu không thì	otherwise
viết	writing
nhấn	press
Nam giới	male
khởi đầu	start
sống sót	alive
biểu hiện	expression
bóng đá	football
dự định	intend
tấn công	attack
gà	chicken
quân đội	army
lạm dụng	abuse
rạp hát	theater
đóng lại	shut
bản đồ	map
thêm	extra
phiên họp	session
nguy hiểm	danger
chào mừng	welcome
trong nước	domestic
rất nhiều	lots
văn chương	literature
mưa	rain
khao khát	desire
thẩm định	assessment
đánh giá	assessment
chấn thương	injury
sự tôn trọng	respect
Phương bắc	northern
gật đầu	nod
Sơn	paint
nhiên liệu	fuel
lá	leaf
thẳng thắn	direct
khô	dry
Người Nga	Russian
chỉ dẫn	instruction
chiến đấu	fight
bơi	pool
leo	climb
ngọt	sweet
chì	lead
động cơ	engine
thứ tư	fourth
Muối	salt
mở rộng	expand
tầm quan trọng	importance
kim loại	metal
mập	fat
vé	ticket
phần mềm	software
biến mất	disappear
công ty	corporate
kỳ lạ	strange
môi	lip
đọc hiểu	reading
đô thị	urban
tâm thần	mental
ngày càng	increasingly
Bữa trưa	lunch
giáo dục	educational
một vài nơi	somewhere
nông phu	farmer
ở trên	above
đường	sugar
hành tinh	planet
yêu thích	favorite
khám phá	explore
đạt được	obtain
kẻ thù	enemy
vĩ đại nhất	greatest
phức tạp	complex
vây quanh	surround
lực sĩ	athlete
mời gọi	invite
nói lại	repeat
cẩn thận	carefully
Linh hồn	soul
thuộc về khoa học	scientific
Không thể nào	impossible
bảng điều khiển	panel
Ý nghĩa	meaning
mẹ	mom
cưới nhau	married
một mình	alone
dụng cụ	instrument
tiên đoán	predict
thời tiết	weather
tổng thống	presidential
đa cảm	emotional
cam kết	commitment
Tối cao	Supreme
chịu	bear
bỏ túi	pocket
gầy	thin
nhiệt độ	temperature
sự ngạc nhiên	surprise
thăm dò ý kiến	poll
đề nghị	proposal
hậu quả	consequence
một nửa	half
hơi thở	breath
thị giác	sight
che	cover
cân đối	balance
thông qua	adopt
thiểu số	minority
thẳng	straight
cố gắng	attempt
kết nối	connect
công trinh	works
giảng bài	teaching
thuộc về	belong
viện trợ	aid
khuyên bảo	advice
đuợc	okay
ảnh chụp	photograph
trống	empty
khu vực	regional
đường mòn	trail
cuốn tiểu thuyết	novel
mã	code
bằng cách nào đó	somehow
tổ chức	organize
ban bồi thẩm	jury
nhũ hoa	breast
Iraqi	Iraqi
Nhân loại	human
công nhận	acknowledge
chủ đề	theme
bão táp	storm
liên hiệp	union
ghi lại	record
bàn	desk
nỗi sợ	fear
cảm ơn	thanks
trái cây	fruit
Dưới	under
đắt	expensive
màu vàng	yellow
phần kết luận	conclusion
nguyên tố	prime
bóng	shadow
đấu tranh	struggle
kết luận	conclude
nhà phân tích	analyst
nhảy	dance
giới hạn	limit
như	like
Quy định	regulation
đang	being
Cuối cùng	last
nhẫn	ring
phần lớn	largely
sự thay đổi	shift
thu nhập	revenue
dấu	mark
định vị	locate
quận	county
xuất hiện	appearance
gói	package
khó khăn	difficulty
cầu	bridge
giới thiệu	recommend
hiển nhiên	obvious
xe lửa	train
về cơ bản	basically
email	email
tạo ra	generate
nữa không	anymore
cầu hôn	propose
Suy nghĩ	thinking
có thể	possibly
khuynh hướng	trend
khách thăm quan	visitor
tiền vay	loan
hiện tại	currently
Thoải mái	comfortable
nhà đầu tư	investor
nhưng	but
lợi nhuận	profit
bực bội	angry
phi hành đoàn	crew
sâu	deep
Tai nạn	accident
Nam giới	male
bữa ăn	meal
thính giác	hearing
giao thông	traffic
cơ bắp	muscle
khái niệm	notion
nắm bắt	capture
thích hơn	prefer
thực sự	truly
trái đất	earth
tiếng Nhật	Japanese
ngực	chest
Tìm kiếm	search
dày	thick
tiền mặt	cash
viện bảo tàng	museum
sắc đẹp	beauty
vẻ đẹp	beauty
trường hợp khẩn cấp	emergency
độc nhất	unique
đặc tính	feature
bên trong	internal
dân tộc	ethnic
liên kết	link
nhấn mạnh	stress
Nội dung	content
lựa chọn	select
nguồn gốc	root
mũi	nose
khai	declare
ở ngoài	outside
đánh giá	appreciate
thực tế	actual
chai	bottle
khó khăn	hardly
cài đặt	setting
phóng	launch
trang phục	dress
tập tin	file
đau ốm	sick
kết quả	outcome
quảng cáo	ad
phòng thủ	defend
vấn đề	matter
thẩm phán	judge
nhiệm vụ	duty
tấm	sheet
nên	ought
đảm bảo	ensure
Công giáo	Catholic
vô cùng	extremely
phạm vi	extent
thành phần	component
pha trộn	mix
dài hạn	longterm
chậm	slow
tương phản	contrast
vùng	zone
đánh thức	wake
thử thách	challenge
sân bay	airport
giám đốc	chief
nâu	brown
Tiêu chuẩn	standard
áo sơ mi	shirt
Phi công	pilot
cảnh báo	warn
cuối cùng	ultimately
con mèo	cat
sự đóng góp	contribution
sức chứa	capacity
chúng ta	ourselves
bất động sản	estate
hướng dẫn	guide
tình huống	circumstance
tuyết	snow
Anh	English
chính trị gia	politician
lấy trộm	steal
theo đuổi	pursue
trượt	slip
phần trăm	percentage
thịt	meat
buồn cười	funny
cũng không	neither
đất	soil
ảnh hưởng	influence
phẫu thuật	surgery
chính xác	correct
Người Do thái	Jewish
khiển trách	blame
ước tính	estimate
đến hạn	due
bóng rổ	basketball
muộn	late
golf	golf
điều tra	investigate
khùng	crazy
đáng kể	significantly
chuỗi	chain
địa chỉ nhà	address
chi nhánh	branch
sự phối hợp	combination
chỉ	just
thường xuyên	frequently
thống đốc	governor
cứu trợ	relief
người dùng	user
cha	dad
đá	kick
phần	part
cách thức	manner
xưa	ancient
khoảng lặng	silence
Xêp hạng	rating
vàng	golden
chuyển động	motion
tiếng Đức	German
giới tính	gender
giải quyết	solve
chi phí	fee
phong cảnh	landscape
đã sử dụng	used
bát	bowl
công bằng	equal
Dài	long
chính thức	official
ra	forth
khung	frame
điển hình	typical
ngoại trừ	except
thận trọng	conservative
loại bỏ	eliminate
chủ nhà	host
đại sảnh	hall
Lòng tin	trust
đại dương	ocean
ghi bàn	score
hàng	row
nhà sản xuất	producer
đủ khả năng	afford
trong khi đó	meanwhile
chế độ	regime
phân chia	division
xác nhận	confirm
sửa chữa	fix
kháng cáo	appeal
gương	mirror
răng	tooth
thông minh	smart
chiều dài	length
hoàn toàn	entirely
dựa	rely
đề tài	topic
than phiền	complain
vấn đề	issue
biến	variable
trở lại	back
phạm vi	range
Điện thoại	telephone
nhận thức	perception
thu hút	attract
sự tự tin	confidence
phòng ngủ	bedroom
bí mật	secret
món nợ	debt
hiếm	rare
của anh ấy	his
xe tăng	tank
y tá	nurse
phủ sóng	coverage
Sự đối lập	opposition
qua một bên	aside
ở đâu	anywhere
liên kết	bond
tập tin	file
vui lòng	pleasure
bậc thầy	master
kỷ nguyên	era
yêu cầu	requirement
kiểm tra	check
đứng	stand
vui vẻ	fun
sự mong đợi	expectation
canh	wing
tách rời	separate
hiện nay	now
trong sáng	clear
đấu tranh	struggle
nghĩa là	mean
phần nào	somewhat
đổ	pour
khuấy	stir
phán đoán	judgment
dọn dẹp	clean
ngoại trừ	except
bia	beer
Anh	English
tài liệu tham khảo	reference
nước mắt	tear
nghi ngờ	doubt
ban cho	grant
nghiêm túc	seriously
tài khoản	account
bộ trưởng	minister
mục sư	minister
hoàn toàn	totally
anh hùng	hero
công nghiệp	industrial
đám mây	cloud
căng ra	stretch
người chiến thắng	winner
âm lượng	volume
du lịch	travel
giống	seed
ngạc nhiên	surprised
nghỉ ngơi	rest
thời trang	fashion
tiêu	pepper
tách rời	separate
bận	busy
can thiệp	intervention
sao chép	copy
tiền boa	tip
phía dưới	below
giá rẻ	cheap
mục đích	aim
trích dẫn	cite
phúc lợi	welfare
rau	vegetable
màu xám	gray
món ăn	dish
bờ biển	beach
cải tiến	improvement
mọi nơi	everywhere
khai mạc	opening
tổng thể	overall
chia	divide
ban đầu	initial
khủng khiếp	terrible
phản đối	oppose
đồng thời	contemporary
lộ trình	route
nhiều	multiple
Cần thiết	essential
câu hỏi	question
liên đoàn	league
phạm tội	criminal
cẩn thận	careful
cốt lõi	core
phía trên	upper
vội vã	rush
nhất thiết	necessarily
đặc biệt	specifically
mệt mỏi	tired
tăng lên	rise
cà vạt	tie
thuê	employ
ngày lễ	holiday
nhảy	dance
rộng lớn	vast
độ phân giải	resolution
hộ gia đình	household
ít hơn	fewer
sự phá thai	abortion
xa nhau	apart
nhân chứng	witness
trận đấu	match
vừa đủ	barely
ngành	sector
Tiêu biểu	representative
thiếu sót	lack
ở trên	beneath
bên cạnh	beside
đen	black
biến cố	incident
giới hạn	limited
tự hào	proud
lưu lượng	flow
giảng viên	faculty
cố vấn	counselor
nhân chứng	witness
chương	chapter
đồng bào	fellow
ly hôn	divorce
nợ	owe
ống	pipe
Khỏe mạnh	athletic
nhẹ	slight
môn Toán	math
bóng râm	shade
đuôi	tail
duy trì	sustain
gắn kết	mount
nghĩa vụ	obligation
góc	angle
lòng bàn tay	palm
khác nhau	differ
tập quán	custom
cửa hàng	store
nhà kinh tế học	economist
mười lăm	fifteen
Súp	soup
lễ kỷ niệm	celebration
hiệu quả	efficient
hư hại	damage
thành phần	composition
làm vui lòng	satisfy
ngắn gọn	briefly
carbon	carbon
gần hơn	closer
tiêu dùng	consume
kế hoạch	scheme
bẻ khóa	crack
tần số	frequency
thuốc lá	tobacco
người sống sót	survivor
ngoài ra	besides
trong	in
nhà tâm lý học	psychologist
giàu có	wealthy
Thiên hà	galaxy
được	given
quỹ	fund
trượt tuyết	ski
giới hạn	limitation
được	OK
dấu vết	trace
cuộc hẹn	appointment
sở thích	preference
mét	meter
nổ	explosion
bắt giữ	arrest
công khai	publicly
đáng kinh ngạc	incredible
đấu sĩ	fighter
nhanh	rapid
nhận vào	admission
thợ săn	hunter
giáo dục	educate
đau đớn	painful
hữu nghị	friendship
trợ lý	aide
trẻ sơ sinh	infant
tính toán	calculate
năm mươi	fifty
thoát khỏi	rid
hiên nhà	porch
khuynh hướng	tendency
đồng phục	uniform
sự hình thành	formation
học bổng	scholarship
đặt phòng	reservation
hiệu quả	efficiency
chất thải	waste
đủ tiêu chuẩn	qualify
trung tâm mua sắm	mall
lấy được	derive
vụ bê bối	scandal
PC	PC
Hữu ích	helpful
gây ấn tượng	impress
gót chân	heel
giống	resemble
riêng tư	privacy
vải	fabric
sự ngạc nhiên	surprise
Cuộc thi	contest
tỉ lệ	proportion
hướng dẫn	guideline
súng trường	rifle
bảo trì	maintenance
lòng tin chắc	conviction
lừa	trick
hữu cơ	organic
lều	tent
kiểm tra	examination
nhà xuất bản	publisher
củng cố	strengthen
người Pháp	French
đề xuất	proposed
huyền thoại	myth
tinh vi	sophisticated
bò	cow
vv	etc
đứng	standing
ngủ	asleep
quần vợt	tennis
dây thần kinh	nerve
thùng	barrel
ném bom	bombing
thành viên	membership
tỉ lệ	ratio
thực đơn	menu
mua	purchase
gây tranh cãi	controversial
tuyệt vọng	desperate
tỷ lệ	rate
lối sống	lifestyle
hài hước	humor
to tiếng	loud
găng tay	glove
nghi ngờ	suspect
đủ	sufficient
tường thuật	narrative
nhiếp ảnh gia	photographer
máy bay trực thăng	helicopter
Công giáo	Catholic
khiêm tốn	modest
các nhà cung cấp	provider
nông nghiệp	agricultural
nổ tung	explode
Cú đánh	stroke
phạm vi	scope
hình phạt	punishment
ít	handful
tệ	badly
đường chân trời	horizon
Hiếu kỳ	curious
bạn gái	girlfriend
nhắc nhở	prompt
yêu cầu	request
cholesterol	cholesterol
hấp thụ	absorb
điều chỉnh	adjustment
người nộp thuế	taxpayer
hăng hái	eager
hiệu trưởng	principal
chi tiết	detailed
động lực	motivation
nhiệm vụ	assignment
sự hạn chế	restriction
băng qua	across
Palestine	Palestinian
phòng thí nghiệm	laboratory
xưởng	workshop
khác	differently
Tự động	auto
lãng mạn	romantic
bông	cotton
động cơ	motor
kiện	sue
hương vị	flavor
bỏ qua	overlook
phao	float
trải qua	undergo
trình tự	sequence
trình diễn	demonstration
máy bay phản lực	jet
tiêu dùng	consumption
khẳng định	assert
lưỡi	blade
tạm thời	temporary
thuốc men	medication
in	print
cabin	cabin
cắn	bite
quan hệ	relative
phiên bản	edition
thung lũng	valley
của bạn	yours
sân cỏ	pitch
cây thông	pine
rực rỡ	brilliant
đấu với	versus
chế tạo	manufacturing
rủi ro	risk
Christian	Christian
phức tạp	complex
tuyệt đối	absolute
đầu bếp	chef
kỳ thị	discrimination
phản cảm	offensive
tiếng Đức	German
bộ đồ	suit
sự bùng nổ	boom
ghi danh	register
bổ nhiệm	appoint
gia tài	heritage
thần	God
khủng bố	terrorist
có ưu thế	dominant
thành công	successfully
dơ bẩn	shit
Chanh	lemon
đói bụng	hungry
giác quan	sense
khô	dry
đi lang thang	wander
đệ trình	submit
Kinh tế học	economics
trần truồng	naked
đoán trước	anticipate
hạt	nut
di sản	legacy
sự mở rộng	extension
nhún vai	shrug
bay	fly
ắc quy	battery
sự đến	arrival
hợp pháp	legitimate
sự định hướng	orientation
lạm phát	inflation
đối phó	cope
ngọn lửa	flame
cụm	cluster
chủ nhà	host
phụ thuộc	dependent
vòi hoa sen	shower
thể chế	institutional
miêu tả	depict
điều hành	operating
xác thịt	flesh
gara	garage
nhà điều hành	operator
giảng viên	instructor
vay	borrow
hơn nữa	furthermore
phim hài	comedy
thế chấp	mortgage
sự trừng phạt	sanction
mười hai	twelve
hàng tuần	weekly
môi trường sống	habitat
ngũ cốc	grain
chải	brush
ý thức	consciousness
cống hiến	devote
bẻ khóa	crack
phép đo	measurement
tỉnh	province
giảm bớt	ease
tịch thu	seize
đạo đức	ethics
đề cử	nomination
sự cho phép	permission
khôn ngoan	wise
nữ diễn viên	actress
hội nghị thượng đỉnh	summit
axit	acid
tỷ lệ	odds
năng khiếu	gifted
thất vọng	frustration
Trung bình	medium
chức năng	function
thể chất	physically
ban cho	grant
phân biệt	distinguish
bờ biển	shore
nhiều lần	repeatedly
phổi	lung
chắc chắn	firm
chính xác	correct
khác biệt	distinct
nghệ thuật	artistic
đàm luận	discourse
cái rổ	basket
ah	ah
trận đánh	fighting
ấn tượng	impressive
đối thủ	competitor
xấu xí	ugly
lo lắng	worried
miêu tả	portray
bột	powder
ma	ghost
truy vấn	persuade
vừa phải	moderate
sau đó	subsequent
tiếp tục	continued
bánh quy	cookie
vận chuyển	carrier
nấu nướng	cooking
Thường xuyên	frequent
lệnh cấm	ban
lung lay	swing
trái cam	orange
kinh khủng	awful
ngưỡng mộ	admire
vật nuôi	pet
phép màu	miracle
quá	exceed
nhịp	rhythm
phổ biến rộng rãi	widespread
giết chết	killing
đáng yêu	lovely
tội	sin
từ thiện	charity
kịch bản	script
chiến thuật	tactic
nhận biết	identification
chuyển đổi	transformation
mỗi ngày	everyday
tiêu đề	headline
tai nạn	crash
liên doanh	venture
cuộc xâm lăng	invasion
quân đội	military
dù sao	nonetheless
đầy đủ	adequate
đàn piano	piano
tạp hóa	grocery
cường độ	intensity
cao	high
cái mền	blanket
lề	margin
tiền vệ	quarterback
chuột	mouse
dây thừng	rope
bê tông	concrete
đơn thuốc	prescription
Người Mỹ gốc Phi	AfricanAmerican
đuổi theo	chase
tài liệu	document
gạch	brick
tuyển dụng	recruit
vá	patch
sự đồng thuận	consensus
kinh dị	horror
ghi âm	recording
thay đổi	changing
họa sĩ	painter
thuộc địa	colonial
chiếc bánh	pie
lợi ích	sake
nhìn chằm chằm	gaze
lòng can đảm	courage
mang thai	pregnancy
xin thề	swear
đánh bại	defeat
manh mối	clue
củng cố	reinforce
thắng lợi	win
sự nhầm lẫn	confusion
lát	slice
nghề nghiệp	occupation
kính thưa	dear
than	coal
Linh thiêng	sacred
phạm tội	criminal
công thức	formula
nhận thức	cognitive
tập thể	collective
chính xác	exact
Chú	uncle
Quảng trường	square
đội trưởng	captain
thở dài	sigh
thuộc tính	attribute
dám	dare
đuợc	okay
Vô gia cư	homeless
mát mẻ	cool
bộ sưu tập	gallery
bóng đá	soccer
bị cáo	defendant
đường hầm	tunnel
sự tập thể dục	fitness
vòng	lap
phần mộ	grave
ngón chân	toe
thùng đựng hàng	container
Đức hạnh	virtue
ở nước ngoài	abroad
kiến trúc sư	architect
đột ngột	dramatically
trang điểm	makeup
yêu cầu	inquiry
bông hồng	rose
thật ngạc nhiên	surprisingly
Điểm nổi bật	highlight
giảm bớt	decrease
dấu hiệu	indication
đường sắt	rail
ngày kỷ niệm	anniversary
đi văng	couch
liên minh	alliance
giả thuyết	hypothesis
bạn trai	boyfriend
biên soạn	compose
ngang nhau	peer
lộn xộn	mess
cấp	rank
huyền thoại	legend
quy định	regulate
thanh niên	adolescent
tỏa sáng	shine
định mức	norm
buồn bã	upset
nhận xét	remark
từ chức	resign
dịu dàng	gentle
liên quan	related
đàn organ	organ
nhẹ nhàng	lightly
có liên quan	concerning
phát minh	invent
tiếng cười	laughter
Phù hợp	fit
Tây Bắc	northwest
tư vấn	counseling
chặt chẽ	tight
người nhận	receiver
lễ nghi	ritual
côn trùng	insect
làm gián đoạn	interrupt
cá hồi	salmon
ủng hộ	favor
thương mại	trading
mối quan ngại	concern
cấp trên	superior
chống lại	combat
thân cây	stem
bác sĩ phẫu thuật	surgeon
chấp nhận được	acceptable
vật lý	physics
hãm hiếp	rape
lời khuyên	counsel
chải	brush
Quần jean	jeans
săn bắn	hunt
liên tiếp	continuous
đăng nhập	log
echo	echo
Viên thuốc	pill
bị kích thích	excited
điêu khắc	sculpture
hợp chất	compound
tích hợp	integrate
bột mì	flour
đắng	bitter
trần	bare
dốc	slope
thuê	rent
chức tổng thống	presidency
phục vụ	serving
tế nhị	subtle
rất nhiều	greatly
giám mục	bishop
uống	drinking
sự chậm trễ	delay
khóc	cry
chấp thuận	acceptance
sự sụp đổ	collapse
cửa tiệm	shop
máy bơm	pump
Cục kẹo	candy
tà ác	evil
sau cùng	final
tài chính	finance
vừa lòng	pleased
huy chương	medal
ăn xin	beg
nhà tài trợ	sponsor
đạo đức	ethical
thứ hai	secondary
sập	slam
xuất khẩu	export
thử nghiệm	experimental
tan chảy	melt
nữa đêm	midnight
mạng lưới	net
đường cong	curve
chính trực	integrity
quyền lợi	entitle
hiển nhiên	evident
logic	logic
Bản chất	essence
công viên	park
loại trừ	exclude
khắc nghiệt	harsh
tủ quần áo	closet
ngoại ô	suburban
chào hỏi	greet
ủng hộ	favor
Nội địa	interior
hành lang	corridor
giết người	murder
bán lẻ	retail
người bình	pitcher
tháng Ba	march
con rắn	snake
sân cỏ	pitch
tha	excuse
vượt qua	cross
yếu đuối	weakness
con lợn	pig
lạnh	cold
cổ điển	classical
ước tính	estimated
Áo thun	Tshirt
Trực tuyến	online
thất nghiệp	unemployment
nền văn minh	civilization
gập lại	fold
bệnh nhân	patient
nhạc pop	pop
hằng ngày	daily
đảo ngược	reverse
mất tích	missing
tương quan	correlation
nhân loại	humanity
đèn flash	flash
nhà phát triển	developer
đáng tin cậy	reliable
sự phấn khích	excitement
thịt bò	beef
đạo Hồi	Islam
Roman	Roman
căng ra	stretch
kiến trúc	architecture
thỉnh thoảng	occasional
hành chính	administrative
khuỷu tay	elbow
chết người	deadly
Hồi giáo	Muslim
Người Hispanic	Hispanic
cáo buộc	allegation
tiền boa	tip
nhầm lẫn	confuse
Máy bay	airplane
hàng tháng	monthly
con vịt	duck
liều	dose
Hàn Quốc	Korean
biện hộ	plead
bắt đầu	initiate
bài học	lecture
van	van
thứ sáu	sixth
bay	bay
dòng chính	mainstream
ngoại ô	suburb
sandwich	sandwich
không giống	unlike
Thân cây	trunk
tin đồn	rumor
thực hiện	implementation
nuốt	swallow
động viên	motivate
render	render
thời gian dài	longtime
bẩy	trap
giới hạn	restrict
vải	cloth
có vẻ	seemingly
lập pháp	legislative
hiệu quả	effectiveness
thi hành	enforce
ống kính	lens
chạm tới	reach
thanh tra	inspector
cho vay	lend
trơn	plain
gian lận	fraud
đồng hành	companion
đấu tranh	contend
móng tay	nail
mảng	array
nghiêm khắc	strict
tập hợp	assemble
thẳng thắn	frankly
con chuột	rat
nổ	burst
hành lang	hallway
hang	cave
chắc chắn xảy ra	inevitable
tây nam	southwest
quái vật	monster
tốc độ	speed
phản đối	protest
bất ngờ	unexpected
trở ngại	obstacle
tạo điều kiện	facilitate
gặp gỡ	encounter
Yên nghỉ	rip
thảo mộc	herb
áp đảo	overwhelming
hội nhập	integration
pha lê	crystal
suy thoái kinh tế	recession
muốn	wish
hàng đầu	top
bằng văn bản	written
động cơ	motive
nhãn	label
lũ	flood
cây bút	pen
sở hữu	ownership
ác mộng	nightmare
để ý	notice
kiểm tra	inspection
người giám sát	supervisor
tham khảo ý kiến	consult
đấu trường	arena
cười	laugh
chẩn đoán	diagnosis
chiếm hữu	possession
tha lỗi	forgive
ấm áp	warm
nhất quán	consistently
tầng hầm	basement
dự án	project
trôi dạt	drift
ráo nước	drain
Cuối cùng	last
truy tố	prosecution
tối đa	maximum
thông báo	announcement
chiến binh	warrior
dự đoán	prediction
vi khuẩn	bacteria
bảng câu hỏi	questionnaire
bùn	mud
cơ sở hạ tầng	infrastructure
vội	hurry
đặc quyền	privilege
ngôi đền	temple
ngoài trời	outdoor
hút	suck
và	and
phát sóng	broadcast
lại	re
nhảy vọt	leap
ngẫu nhiên	random
quá khứ	past
cổ tay	wrist
tấm màn	curtain
giám sát	monitor
ao	pond
miền	domain
tội lỗi	guilt
gia súc	cattle
môn học	subject
đi dạo	walking
playoff	playoff
tài chính	fiscal
váy	skirt
đổ	dump
vì thế	hence
cơ sở dữ liệu	database
khó chịu	uncomfortable
mục đích	aim
thi hành	execute
chân tay	limb
hệ tư tưởng	ideology
Trung bình cộng	average
chào mừng	welcome
điều chỉnh	tune
tiếp tục	continuing
làm hại	harm
đường sắt	railroad
chịu đựng	endure
sự bức xạ	radiation
sừng	horn
mãn tính	chronic
bình yên	peaceful
đổi mới	innovation
sự căng thẳng	strain
đàn ghi ta	guitar
thay thế	replacement
hành xử	behave
quản lý	administer
đồng thời	simultaneously
vũ công	dancer
sửa đổi	amendment
bảo vệ	guard
tập giấy	pad
truyền tải	transmission
chờ đợi	await
nghỉ hưu	retired
cò súng	trigger
tràn	spill
tri ân	grateful
ân sủng	grace
ảo	virtual
phản ứng	response
thuộc địa	colony
nhận con nuôi	adoption
trượt	slide
bản địa	indigenous
đóng	closed
tù nhân	convict
dân thường	civilian
khăn tắm	towel
sửa đổi	modify
hạt	particle
giải thưởng	award
nháy mắt	glance
giải thưởng	prize
đổ bộ	landing
hạnh kiểm	conduct
màu xanh da trời	blue
tăng	boost
gậy	bat
báo thức	alarm
lễ hội	festival
nắm chặt	grip
kỳ dị	weird
phá hoại	undermine
sinh viên năm nhất	freshman
mồ hôi	sweat
bên ngoài	outer
Châu Âu	European
say	drunk
khảo sát	survey
nghiên cứu	research
tách biệt	separation
theo truyền thống	traditionally
đồ đạc	stuff
quản lý	govern
Đông Nam	southeast
thông minh	intelligent
ở đâu	wherever
phiếu	ballot
Hùng biện	rhetoric
thuyết phục	convinced
điều khiển	driving
vitamin	vitamin
hăng hái	enthusiasm
chứa	accommodate
ca ngợi	praise
làm bị thương	injure
hoang dã	wilderness
gần đó	nearby
bất tận	endless
ủy nhiệm	mandate
tạm ngừng	pause
tha	excuse
tương ứng	respectively
tính không chắc chắn	uncertainty
hỗn loạn	chaos
ngắn	short
cơ khí	mechanical
Tranh sơn dầu	canvas
bốn mươi	forty
vấn đề	matter
sảnh đợi	lobby
thâm thúy	profound
định dạng	format
đặc điểm	trait
tiền tệ	currency
gà tây	turkey
dự trữ	reserve
chùm tia	beam
lạm dụng	abuse
nhà thiên văn học	astronomer
tham nhũng	corruption
nhà thầu	contractor
xin lỗi	apologize
học thuyết	doctrine
chính hãng	genuine
ngón tay cái	thumb
thống nhất	unity
thỏa hiệp	compromise
kinh khủng	horrible
hành vi	behavioral
độc quyền	exclusive
tiêu tan	scatter
thông thường	commonly
chuyên chở	convey
vội vã	rush
xoắn	twist
phức tạp	complexity
cái nĩa	fork
đĩa	disk
giải tỏa	relieve
nghi ngờ	suspicion
Khóa	lock
hoàn thành	finish
nơi cư trú	residence
xấu hổ	shame
có ý nghĩa	meaningful
đường đi bộ	sidewalk
Thế vận hội	Olympics
công nghệ	technological
Chữ ký	signature
dễ chịu	pleasant
wow	wow
đình chỉ	suspend
nổi loạn	rebel
đông lạnh	frozen
khao khát	desire
vợ hoặc chồng	spouse
chất lỏng	fluid
lương hưu	pension
tiếp tục	resume
lý thuyết	theoretical
natri	sodium
thổi	blow
quảng cáo	promotion
tinh tế	delicate
trán	forehead
xây dựng lại	rebuild
tung lên	bounce
điện	electrical
cái móc	hook
thám tử	detective
du khách	traveler
nhấp chuột	click
đền bù	compensation
tín hiệu	signal
lối thoát	exit
sức hút	attraction
dâng hiến	dedicate
hoàn toàn	altogether
nhặt lên	pickup
khắc chạm	carve
cây kim	needle
bụng	belly
tàu	ship
sợ hãi	scare
danh mục đầu tư	portfolio
đưa đón	shuttle
vô hình	invisible
thời gian	timing
hôn ước	engagement
mắt cá	ankle
Giao dịch	transaction
đối tác	counterpart
lịch sử	historically
vững chắc	firmly
nhẹ nhàng	mild
người lái	rider
búp bê	doll
trưa	noon
triển lãm	exhibit
giữa	amid
giống nhau	identical
tóm lược	precise
lo lắng	anxious
cấu trúc	structural
nhà ở	residential
to tiếng	loud
chẩn đoán	diagnose
carbohydrate	carbohydrate
tự do	liberty
áp phích	poster
thần học	theology
phi lợi nhuận	nonprofit
thu thập thông tin	crawl
ôxy	oxygen
đẹp	handsome
ma thuật	magic
tổng hợp	sum
cung cấp	provided
doanh nhân	businessman
hứa hẹn	promising
có ý thức	conscious
sự quyết tâm	determination
nhà tài trợ	donor
của cô ấy	hers
mục sư	pastor
jazz	jazz
opera	opera
tiếng Nhật	Japanese
cắn	bite
khung	frame
tà ác	evil
mua lại	acquisition
hố	pit
ôm	hug
động vật hoang dã	wildlife
trừng phạt	punish
khổng lồ	giant
sơ cấp	primary
công bằng	equity
sai rồi	wrong
lối vào	doorway
khởi hành	departure
thang máy	elevator
thiếu niên	teenage
hướng dẫn	guidance
hạnh phúc	happiness
bức tượng	statue
theo đuổi	pursuit
sửa	repair
phong nha	decent
phòng thể dục	gym
miệng	oral
nhân viên bán hàng	clerk
Israeli	Israeli
phong bì	envelope
Báo cáo	reporting
nơi đến	destination
nắm tay	fist
chứng thực	endorse
thăm dò	exploration
hào phóng	generous
bồn tắm	bath
cứu hộ	rescue
bằng cách ấy	thereby
tổng thể	overall
chỉ thị	indicator
ánh sáng mặt trời	sunlight
Phản hồi	feedback
quang phổ	spectrum
màu tím	purple
laser	laser
Dũng cảm	bold
lưỡng lự	reluctant
bắt đầu	starting
chuyên môn	expertise
thực tế	practically
chương trình	program
hình ảnh	picture
Ăn	eating
tuổi tác	age
Tình nguyện	volunteer
dấu	hint
mạnh	sharply
diễu hành	parade
biện hộ	advocate
cảnh giới	realm
lệnh cấm	ban
dải	strip
hủy bỏ	cancel
trộn	blend
nhà trị liệu	therapist
lát	slice
lột vỏ	peel
pizza	pizza
người nhận	recipient
do dự	hesitate
lật	flip
kế toán	accounting
tranh luận	debate
sự thiên vị	bias
Huh	huh
phép ẩn dụ	metaphor
nến	candle
xử lý	handle
lo	worry
tư pháp	judicial
thực thể	entity
đau khổ	suffering
toàn thời gian	fulltime
cảm thấy	feel
đèn	lamp
rác thải	garbage
người hầu	servant
thêm vào	addition
quy định	regulatory
ngoại giao	diplomatic
thanh lịch	elegant
phía trong	inside
tiếp nhận	reception
biến mất	vanish
tự động	automatically
cái cằm	chin
đường mòn	trail
sự cần thiết	necessity
xưng	confess
chủ nghĩa phân biệt chủng tộc	racism
bắt đầu	starter
Nội địa	interior
ngân hàng	banking
giản dị	casual
nghiêm trọng	gravity
ghi danh	enroll
suy giảm	diminish
Phòng ngừa	prevention
Arab	Arab
giá trị	value
giảm thiểu	minimize
chặt	chop
người biểu diễn	performer
ý định	intent
cô lập	isolate
máy bơm	pump
hàng tồn kho	inventory
có năng suất	productive
tổ hợp	assembly
công dân	civic
lụa	silk
độ lớn	magnitude
dốc	steep
con tin	hostage
người thu gom	collector
phổ biến	popularity
hôn	kiss
người ngoài hành tinh	alien
năng động	dynamic
đáng sợ	scary
phương trình	equation
Thiên thần	angel
công tắc điện	switch
chào bán	offering
giận dữ	rage
nhiếp ảnh	photography
sửa	repair
phòng vệ sinh	toilet
thất vọng	disappointed
quí	precious
cấm	prohibit
Tiêu biểu	representative
Nội dung	content
thực tế	realistic
Người Nga	Russian
ẩn	hidden
chỉ huy	command
đấu thầu	tender
đánh thức	wake
thu thập	gathering
nổi bật	outstanding
tình cờ gặp	stumble
cô đơn	lonely
ôtô	automobile
nhân tạo	artificial
bình minh	dawn
trừu tượng	abstract
hạ xuống	descend
ngớ ngẩn	silly
cái móc	hook
thủy triều	tide
chia sẻ	shared
hy vọng	hopefully
dễ dàng	readily
hợp tác	cooperate
cách mạng	revolutionary
lãng mạn	romance
phần cứng	hardware
cái gối	pillow
bộ dụng cụ	kit
nấu ăn	cook
Lan tràn	spread
lục địa	continent
niêm phong	seal
mạch	circuit
bồn rửa	sink
phán quyết	ruling
sự thiếu	shortage
hàng năm	annually
gần đây	lately
bẩy	trap
quét	scan
ngu xuẩn	fool
hạn chót	deadline
phía sau	rear
Chế biến	processing
trang trại	ranch
duyên hải	coastal
thực hiện	undertake
nhẹ nhàng	softly
dự trữ	reserve
đốt	burning
lời nói	verbal
bộ lạc	tribal
nực cười	ridiculous
tự động	automatic
kim cương	diamond
uy tín	credibility
nhập khẩu	import
tình dục	sexually
mùa xuân	spring
đường	way
thần thánh	divine
tình cảm	sentiment
xe đẩy	cart
giám sát	oversee
thân cây	stem
đàn anh	elder
pro	pro
cảm hứng	inspiration
Người Hà Lan	Dutch
số lượng	quantity
trailer	trailer
người bạn đời	mate
giờ	oclock
người Hy Lạp	Greek
Thiên tài	genius
tượng đài	monument
BID	bid
nhiệm vụ	quest
lời mời	invitation
tính chính xác	accuracy
bồi thẩm đoàn	juror
chính thức	officially
người môi giới	broker
kho báu	treasure
lòng trung thành	loyalty
tín dụng	credit
sốc	shock
có tài	talented
xăng	gasoline
cứng	stiff
đầu ra	output
ứng cử viên	nominee
mở rộng	extended
xin vui lòng	please
Bệnh tiểu đường	diabetes
tát	slap
chất độc	toxic
cáo buộc	alleged
hàm	jaw
đau buồn	grief
huyền bí	mysterious
tên lửa	rocket
hiến tặng	donate
tù nhân	inmate
giải quyết	tackle
động lực học	dynamics
cây cung	bow
của chúng tôi	ours
cao cấp	senior
phẩm giá	dignity
thảm	carpet
cha mẹ	parental
bong bóng	bubble
nhiệt	heat
Bạn bè	buddy
chuồng trại	barn
thanh kiếm	sword
thứ bảy	seventh
vinh quang	glory
chặt chẽ	tightly
bảo vệ	protective
tuck	tuck
trống	drum
mờ nhạt	faint
bài đăng	post
nữ hoàng	queen
tình trạng khó xử	dilemma
đầu vào	input
chuyên môn hóa	specialize
đông bắc	northeast
nông	shallow
trách nhiệm pháp lý	liability
cánh buồm	sail
thương gia	merchant
sân vận động	stadium
cải tiến	improved
dính máu	bloody
đánh bại	defeat
liên kết	associated
thu hồi	withdrawal
tủ lạnh	refrigerator
tổ	nest
ở gần	near
triệt để	thoroughly
lane	lane
tổ tiên	ancestor
lên án	condemn
hơi nước	steam
giọng điệu	accent
thoát khỏi	escape
lạc quan	optimistic
thống nhất	unite
cái lồng	cage
Trang bị	equip
con tôm	shrimp
quê hương	homeland
trao đổi	exchange
giá đỡ	rack
trang phục	costume
chó sói	wolf
phòng xử án	courtroom
đạo luật	statute
hoạt hình	cartoon
năng suất	productivity
nụ cười	grin
tượng trưng	symbolic
lỗi	bug
ban phước	bless
cô dì	aunt
nông nghiệp	agriculture
đá	rock
Hostile	hostile
nguồn gốc	root
thụ thai	conceive
kết hợp	combined
ngay lập tức	instantly
phá sản	bankruptcy
vắcxin	vaccine
thưởng	bonus
hợp tác	collaboration
pha trộn	mixed
phản đối	opposed
quỹ đạo	orbit
sự hiểu biết	grasp
kiên nhẫn	patience
bất bình	spite
nhiệt đới	tropical
bầu cử	voting
tuần tra	patrol
sự sẵn lòng	willingness
Chức vụ	position
sự mặc khải	revelation
thuê	rent
đồ trang sức	jewelry
Cuba	Cuban
lôi	haul
công nhận	concede
dấu vết	trace
toa xe	wagon
sau đó	afterward
đẹp mắt	spectacular
phá hoại	ruin
tuyệt	sheer
trước	prior
miễn dịch	immune
độ tin cậy	reliability
mông	ass
bên cạnh	alongside
cây bụi	bush
kỳ lạ	exotic
hấp dẫn	fascinating
đảm bảo	secure
kẹp	clip
đùi	thigh
con bò	bull
ngăn kéo	drawer
quan tâm	regard
cừu	sheep
gây chán nản cho	discourage
điều phối viên	coordinator
ý thức hệ	ideological
người chạy	runner
thế tục	secular
thân mật	intimate
đế chế	empire
taxi	cab
ly hôn	divorce
thi	exam
phim tài liệu	documentary
Trung tính	neutral
sinh học	biology
linh hoạt	flexible
cấp tiến	progressive
web	web
âm mưu	conspiracy
bắt lấy	catch
tai nạn	casualty
nước cộng hòa	republic
chấp hành	execution
khủng khiếp	terrific
cá voi	whale
chức năng	functional
ngôi sao	star
bản nháp	draft
bản năng	instinct
đồng đội	teammate
nhôm	aluminum
bất cứ ai	whoever
Bộ	ministry
bản án	verdict
dạy	instruct
sọ	skull
lòng tự trọng	selfesteem
giảm bớt	ease
hợp tác xã	cooperative
vận dụng	manipulate
con ong	bee
học viên	practitioner
vòng lặp	loop
chỉnh sửa	edit
roi da	whip
câu đố	puzzle
nấm	mushroom
trợ cấp	subsidy
sôi lên	boil
bi kịch	tragic
toán học	mathematics
thợ cơ khí	mechanic
lọ	jar
sự tôn trọng	respect
động đất	earthquake
thịt heo	pork
sáng tạo	creativity
an toàn	safely
cơ bản	underlying
món tráng miệng	dessert
cảm thông	sympathy
ngư dân	fisherman
vô cùng	incredibly
cô lập	isolation
bít tất	sock
ở gần	near
nhảy	jump
mười một	eleven
sexy	sexy
doanh nhân	entrepreneur
hội chứng	syndrome
phòng làm việc	bureau
ghế	seat
nơi làm việc	workplace
tham vọng	ambition
đụng	touchdown
sử dụng	utilize
khoe khoang	breeze
tốn kém	costly
đầy tham vọng	ambitious
Cơ đốc giáo	Christianity
có lẽ	presumably
có ảnh hưởng	influential
dịch	translation
không chắc chắn	uncertain
giải thể	dissolve
vật	object
thống kê	statistical
ruột	gut
đô thị	metropolitan
lăn	rolling
thẩm mỹ	aesthetic
Đánh vần	spell
chèn	insert
gian hàng	booth
mũ bảo hiểm	helmet
eo	waist
kỳ vọng	expected
sư tử	lion
hoàn thành	accomplishment
hoàng tộc	royal
hoảng loạn	panic
dàn diễn viên	cast
nghiền nát	crush
tích cực	actively
vách đá	cliff
tối thiểu	minimal
dây	cord
may mắn	fortunately
cocaine	cocaine
ảo giác	illusion
vô danh	anonymous
tha thứ	tolerate
sự đánh giá	appreciation
ủy viên	commissioner
làm hại	harm
Mềm dẻo	flexibility
hướng dẫn	instructional
tranh giành	scramble
casino	casino
khối u	tumor
trang trí	decorate
sắp xếp	sort
sạc điện	charge
xung	pulse
tương đương	equivalent
đã sửa	fixed
có kinh nghiệm	experienced
Quyên góp	donation
Nhật ký	diary
anh chị em ruột	sibling
mỉa mai	irony
cái thìa	spoon
giữa	midst
hẻm	alley
buồn bã	upset
tương tác	interact
xà bông	soap
dễ thương	cute
đối thủ	rival
thời gian ngắn	shortterm
đấm	punch
ghim	pin
khúc côn cầu	hockey
đi qua	passing
tồn tại	persist
nhà cung cấp	supplier
nổi tiếng	known
Đà	momentum
cái ví	purse
đổ ra	shed
biểu tượng	icon
con voi	elephant
hậu quả là	consequently
cơ quan lập pháp	legislature
nhượng quyền thương mại	franchise
đúng	correctly
tinh thần	mentally
nuôi dưỡng	foster
Xe đạp	bicycle
khuyến khích	encouraging
lừa đảo	cheat
truy cập	access
chữa lành	heal
sốt	fever
lọc	filter
Con thỏ	rabbit
đồng tiền	coin
khai thác	exploit
có thể truy cập	accessible
cơ thể	organism
cảm giác	sensation
một phần	partially
ở lại	stay
tầng trên	upstairs
khô	dried
tối thiểu	minimum
pro	pro
bảo tồn	conservation
xô	shove
sân sau	backyard
điều lệ	charter
bếp	stove
bằng lòng	consent
bao gồm	comprise
nhắc nhở	reminder
như nhau	alike
vị trí	placement
bột	dough
cháu ngoại	grandchild
con đập	dam
báo cáo	reportedly
nổi tiếng	wellknown
xung quanh	surrounding
sinh thái	ecological
trang phục	outfit
chưa từng có	unprecedented
nhà bình luận viên	columnist
tập thể dục	workout
sơ bộ	preliminary
bằng sáng chế	patent
nhát	shy
Trích dẫn	quote
rác	trash
tàn tật	disabled
Tổng	gross
chỉ trích	damn
hoocmon	hormone
kết cấu	texture
quầy tính tiền	counter
bút chì	pencil
biên giới	frontier
Xịt nước	spray
cá cược	bet
tiết lộ	disclose
quyền nuôi con	custody
chủ ngân hàng	banker
quái thú	beast
gây trở ngại	interfere
cây sồi	oak
trường hợp	case
thứ tám	eighth
sổ tay	notebook
đề cương	outline
sự tham dự	attendance
suy đoán	speculation
khám phá	uncover
thay mặt	behalf
sáng tạo	innovative
cá mập	shark
phần thưởng	reward
cối xay	mill
cài đặt	installation
kích thích	stimulate
nhãn	tag
theo chiều dọc	vertical
bơi lội	swimming
hạm đội	fleet
mục lục	catalog
người ngoài	outsider
sự hy sinh	sacrifice
tuyệt vọng	desperately
lập trường	stance
bắt buộc	compel
nhạy cảm	sensitivity
một ngày nào đó	someday
ra mắt	debut
tuyên bố	proclaim
đi lang thang	hike
cần thiết	required
đối đầu	confrontation
Đầy màu sắc	colorful
lý tưởng	ideal
hiến pháp	constitution
người huấn luyện	trainer
Lễ Tạ ơn	Thanksgiving
hương thơm	scent
cây rơm	stack
lông mày	eyebrow
bao	sack
ngưng	cease
thừa kế	inherit
cái mâm	tray
người tiên phong	pioneer
tổ chức	organizational
sách giáo khoa	textbook
uh	uh
bẩn thỉu	nasty
co lại	shrink
mô hình	model
mới nổi	emerging
dấu chấm	dot
lúa mì	wheat
khốc liệt	fierce
hình dung	envision
hợp lý	rational
Vương quốc	kingdom
lối đi	aisle
làm suy yếu	weaken
giao thức	protocol
duy nhất	exclusively
tiếng hát	vocal
thương trường	marketplace
cởi mở	openly
không công bằng	unfair
địa hình	terrain
triển khai	deploy
rủi ro	risky
mỳ ống	pasta
thể loại	genre
làm mất tập trung	distract
n	merit
lập kế hoạch	planner
suy sụp	depressed
mảnh	chunk
gần nhất	closest
giảm giá	discount
Không	no
thang	ladder
rừng nhiệt đới	jungle
di cư	migration
thở	breathing
xâm chiếm	invade
bão	hurricane
nhà bán lẻ	retailer
phân loại	classify
vết thương	wound
cuộc đảo chính	coup
viện trợ	aid
đại sứ	ambassador
tỉ trọng	density
hỗ trợ	supportive
sự tò mò	curiosity
bỏ qua	skip
Hiếu chiến	aggression
kích thích kinh tế	stimulus
báo chí	journalism
robot	robot
lũ	flood
nhúng	dip
tương tự	likewise
không chính thức	informal
Người Ba Tư	Persian
lông vũ	feather
quả cầu	sphere
thắt chặt	tighten
khoe khoan	boast
vỗ vỗ	pat
lĩnh hội	perceived
Duy Nhất	sole
công khai	publicity
chính	major
mở ra	unfold
đùa	joke
hạnh phúc	wellbeing
hiệu lực	validity
hệ sinh thái	ecosystem
nghiêm khắc	strictly
một phần	partial
cổ áo	collar
cỏ dại	weed
sự tuân thủ	compliance
streak	streak
được cho là	supposedly
thêm	added
người xây dựng	builder
nhìn thoáng qua	glimpse
tiền đề	premise
chuyên môn	specialty
thấy	deem
đồ tạo tác	artifact
sneak	sneak
con khỉ	monkey
người cố vấn	mentor
hai phần ba	twothirds
người nghe	listener
sét đánh	lightning
hợp pháp	legally
tay áo	sleeve
thất vọng	disappointment
xáo trộn	disturb
xương sườn	rib
quá đáng	excessive
công nghệ cao	hightech
mảnh vụn	debris
Đóng cọc	pile
gậy	rod
hợp lý	logical
tự do	liberal
tro	ash
xã hội	socially
giáo xứ	parish
chế độ nô lệ	slavery
chỗ trống	blank
hàng hóa	commodity
chữa khỏi	cure
khoáng sản	mineral
đói	hunger
chết	dying
phát triển	developmental
nhanh hơn	faster
phụ tùng	spare
nửa chừng	halfway
chữa khỏi	cure
bình đẳng	equality
Nghĩa trang	cemetery
quấy rối	harassment
thong thả	deliberately
danh tiếng	fame
hối tiếc	regret
nổi bật	striking
khả năng	likelihood
cà rốt	carrot
trên	atop
số điện thoại	toll
rim	rim
xấu hổ	embarrassed
fucking	fucking
bám lấy	cling
bị cô lập	isolated
chớp mắt	blink
nghi ngờ	suspicious
xe lăn	wheelchair
đội hình	squad
hội đủ điều kiện	eligible
bộ vi xử lý	processor
lao xuống	plunge
điều này	this
nụ cười	grin
màu	color
nhân khẩu học	demographic
mưa	rain
làm lạnh	chill
nơi ẩn náu	refuge
chỉ đạo	steer
nhà lập pháp	legislator
biểu tình	rally
lập trình	programming
vui lên	cheer
đầu ra	outlet
nguyên vẹn	intact
nhà cung cấp	vendor
phát đạt	thrive
đậu phụng	peanut
nhai	chew
kỹ lưỡng	elaborate
trí tuệ	intellectual
quan niệm	conception
bán đấu giá	auction
miếng bò hầm	steak
tuân theo	comply
triumph	triumph
cổ đông	shareholder
so sánh	comparable
lương tâm	conscience
phép tính	calculation
đáng kể	considerably
khoảng thời gian	interval
vết trầy	scratch
thức tỉnh	awake
quyền hạn	jurisdiction
chắc chắn	inevitably
nữ quyền sĩ	feminist
hạn chế	constraint
tình cảm	emotionally
thám hiểm	expedition
bị cáo buộc	allegedly
thỏa hiệp	compromise
sự giống nhau	similarity
mông	butt
Nắp	lid
ngớ ngẩn	dumb
số lượng lớn	bulk
rắc	sprinkle
tử vong	mortality
triết học	philosophical
chuyển đổi	conversion
người bảo trợ	patron
thành phố	municipal
bất kì	any
Gan	liver
hòa hợp	harmony
chỉ	solely
lòng khoan dung	tolerance
tức thời	instant
con dê	goat
cánh tay	arm
phước lành	blessing
trái chuối	banana
đang chạy	running
cung điện	palace
trước kia	formerly
nông dân	peasant
khéo léo	neat
ông bà	grandparent
nhà lập pháp	lawmaker
siêu thị	supermarket
du lịch	cruise
di động	mobile
trơn	plain
phần	part
lịch	calendar
Người đàn bà góa	widow
tiền gửi	deposit
râu	beard
phanh	brake
trung tâm thành phố	downtown
kiểm tra	screening
thúc đẩy	impulse
ngăn cấm	forbid
lông thú	fur
tàn bạo	brutal
người ăn thịt	predator
xô	poke
opt	opt
tình nguyện	voluntary
rắc rối	trouble
có hiệu lực	valid
diễn đàn	forum
khiêu vũ	dancing
hạnh phúc	happily
bay lên	soar
gỡ bỏ	removal
tự trị	autonomy
ban hành	enact
tròn	round
chủ đề	thread
ánh sáng	light
mốc	landmark
không vui	unhappy
tội phạm	offender
đang đến	coming
tư nhân	privately
phân số	fraction
đặc biệt	distinctive
du lịch	tourism
ngưỡng	threshold
điềm tĩnh	calm
thường	routinely
suite	suite
nhận xét	remark
người điều tiết	regulator
Rơm rạ	straw
thần học	theological
xa nhau	apart
thoát ra	exhaust
quả địa cầu	globe
mong manh	fragile
sự phản đối	objection
hóa học	chemistry
Cổ hủ	oldfashioned
Đông người	crowded
vòng tròn	circle
vụ nổ	blast
chiếm ưu thế	prevail
qua đêm	overnight
từ chối	denial
thuê	rental
tuyệt diệu	fantastic
miếng	fragment
cấp độ	level
Đinh ốc	screw
ấm áp	warmth
đại học	undergraduate
chất lỏng	liquid
đau đầu	headache
cảnh sát	policeman
năng suất	yield
chiếu	projection
chiến đấu	battle
thích hợp	suitable
đề cập đến	mention
tốt nghiệp	graduation
máy khoan	drill
hung ác	cruel
biệt thự	mansion
quan tâm	regard
giống nho	grape
cho phép	authorize
nhà tranh	cottage
đường lái xe	driveway
quyến rũ	charm
tình dục	sexuality
trung thành	loyal
đất sét	clay
pao	pound
quả bóng bay	balloon
sự phát minh	invention
tự ngã	ego
giá vé	fare
bài tập về nhà	homework
đĩa	disc
ghế sô pha	sofa
Bảo hành	guarantee
khả dụng	availability
radar	radar
nhăn mặt	frown
giành lại	regain
rời khỏi	leave
cho phép	permit
áo len	sweater
phục hồi chức năng	rehabilitation
cao su	rubber
rút lui	retreat
phân tử	molecule
tự do	freely
thuận lợi	favorable
liên tục	steadily
cựu chiến binh	veteran
tích hợp	integrated
ha	ha
thiếu niên	youngster
phí bảo hiểm	premium
trách nhiệm giải trình	accountability
quá tải	overwhelm
một phần ba	onethird
thưởng ngoạn	contemplate
cập nhật	update
tia lửa	spark
trớ trêu thay	ironically
mệt mỏi	fatigue
vượt ra ngoài	beyond
suy đoán	speculate
đánh dấu	marker
thấp	low
rao giảng	preach
cái xô	bucket
bom	bomb
tóc vàng	blond
lời thú tội	confession
kích động	provoke
đá hoa	marble
đáng kể	substantially
xoắn	twist
hậu vệ	defender
cá	fish
rõ ràng	explicit
vận chuyển	transport
phiền	disturbing
giám sát	surveillance
từ tính	magnetic
kỹ thuật viên	technician
lẩm bẩm	mutter
tàn phá	devastating
khởi hành	depart
mũi tên	arrow
chấn thương	trauma
lân cận	neighboring
ngâm	soak
ribbon	ribbon
thời gian chờ đợi	meantime
chuyển giao	transmit
màn	screen
liên tiếp	consecutive
nhà nước cộng hòa	republican
danh từ	coordinate
trên toàn thế giới	worldwide
bên trong	within
gián điệp	spy
khe	slot
bạo loạn	riot
chất dinh dưỡng	nutrient
quyền công dân	citizenship
nghiêm trọng	severely
chủ quyền	sovereignty
cây rơm	ridge
can đảm	brave
thắp sáng	lighting
chỉ định	specify
người đóng góp	contributor
thất vọng	frustrate
đám đông	crowd
khớp nối	articulate
quan trọng	importantly
quá cảnh	transit
dày đặc	dense
hội thảo	seminar
thiết bị điện tử	electronics
nắng	sunny
quần short	shorts
sưng lên	swell
tố cáo	accusation
làm mềm	soften
ảnh chụp	photograph
làm thẳng	straighten
khủng khiếp	terribly
gợi ý	cue
đột nhiên	sudden
cô dâu	bride
tiểu sử	biography
nguy hiểm	hazard
thuyết phục	compelling
ít khi	seldom
ngói	tile
kinh tế	economically
thành thật	honestly
gặp rắc rối	troubled
cây cung	bow
hai mươi	twentieth
cân bằng	balanced
người nước ngoài	foreigner
phóng	launch
tiện	convenience
Hân hoan	delight
dệt	weave
gỗ	timber
cho đến	till
chính xác	accurately
lời bào chữa	plea
bóng đèn	bulb
sao chép	copy
bay	flying
bền vững	sustainable
ác quỷ	devil
chớp	bolt
hàng hóa	cargo
xương sống	spine
người bán	seller
có kỹ năng	skilled
quản lý	managing
công cộng	public
biển	marine
bến tàu	dock
tổ chức	organized
sương mù	fog
nhà ngoại giao	diplomat
nhàm chán	boring
thỉnh thoảng	sometime
tóm lược	summary
nhà truyền giáo	missionary
bệnh dịch	epidemic
gây tử vong	fatal
cắt tỉa	trim
Kho	warehouse
đẩy nhanh	accelerate
Con bướm	butterfly
đồng	bronze
chết chìm	drown
vốn có	inherent
ca ngợi	praise
toàn quốc	nationwide
nhổ	spit
mùa gặt	harvest
quỳ xuống	kneel
Khoảng chân không	vacuum
đã chọn	selected
điều khiển	dictate
khuôn mẫu	stereotype
cảm biến	sensor
giặt ủi	laundry
sổ tay	manual
súng lục	pistol
hải quân	naval
nguyên đơn	plaintiff
đứa trẻ	kid
tầng lớp trung lưu	middleclass
xin lỗi	apology
cho đến	till
